16 14
  0 0 0 0 0 0 0 0 0 0 0 0 0 0 0 0
  0 0 0 0 0 0 0 0 0 0 0 0 0 0 0 0
  0 0 0 0 0 0 0 0 0 0 0 0 0 0 0 0
  0 0 0 0 0 0 0 0 0 0 0 0 0 0 0 0
  0 0 0 0 0 0 0 0 0 0 0 0 0 0 0 0
  0 0 0 0 0 0 0 0 0 0 0 0 0 0 0 0
  0 0 0 0 0 0 0 0 0 0 0 0 0 0 0 0
  0 0 0 0 0 0 0 0 0 0 0 0 0 0 0 0
  0 0 0 0 0 6 7 0 0 6 7 0 0 0 0 0
  0 0 0 0 0 8 9 0 0 8 9 0 0 0 0 0
  0 0 0 0 0 8 9 0 0 8 9 0 0 0 0 0
  1 1 1 1 3 4 4 4 4 4 4 5 1 1 1 1
  2 2 2 2 4 4 4 4 4 4 4 4 2 2 2 2
  2 2 2 2 4 4 4 4 4 4 4 4 2 2 2 2